"a" = (/turf/template_noop,/area/shuttle/caravan/freighter1{outdoors = 1})
"b" = (/obj/structure/closet/crate/wooden,/obj/item/ammo_box/a556,/obj/item/ammo_box/a556,/obj/item/ammo_box/a556,/obj/item/ammo_box/a556,/obj/item/ammo_box/a556,/obj/item/ammo_box/a50MGbox,/obj/item/ammo_box/c4570box,/turf/template_noop,/area/shuttle/caravan/freighter1{outdoors = 1})
"c" = (/mob/living/simple_animal/cow/brahmin{health = 0},/turf/template_noop,/area/shuttle/caravan/freighter1{outdoors = 1})
"d" = (/obj/effect/mob_spawn/human/corpse/bs,/turf/template_noop,/area/shuttle/caravan/freighter1{outdoors = 1})
"e" = (/obj/effect/mob_spawn/human/corpse/raider,/turf/template_noop,/area/shuttle/caravan/freighter1{outdoors = 1})
"f" = (/obj/effect/mob_spawn/human/corpse/ncr,/turf/template_noop,/area/shuttle/caravan/freighter1{outdoors = 1})
"g" = (/obj/structure/closet/crate/large,/obj/item/ammo_box/a556,/obj/item/ammo_box/a556,/obj/item/ammo_box/a556,/obj/item/ammo_box/c9mm,/obj/item/ammo_box/c9mm,/obj/item/ammo_box/a50MGbox,/obj/item/ammo_box/c4570box,/turf/template_noop,/area/shuttle/caravan/freighter1{outdoors = 1})
"h" = (/obj/effect/mob_spawn/human/corpse/ncr,/obj/structure/closet/crate/wooden,/obj/item/gun/ballistic/automatic/pistol/ninemil,/obj/item/gun/ballistic/automatic/pistol/ninemil,/obj/item/gun/ballistic/automatic/pistol/ninemil,/turf/template_noop,/area/shuttle/caravan/freighter1{outdoors = 1})
"i" = (/obj/structure/closet/crate/large,/obj/item/gun/ballistic/automatic/marksman/sniper,/obj/item/gun/ballistic/automatic/rangemaster,/turf/template_noop,/area/shuttle/caravan/freighter1{outdoors = 1})
"j" = (/obj/structure/closet/crate/large,/obj/item/gun/ballistic/automatic/marksman/servicerifle,/obj/item/gun/ballistic/automatic/marksman/servicerifle,/turf/template_noop,/area/shuttle/caravan/freighter1{outdoors = 1})

(1,1,1) = {"
aaaaaaaaaaaaaaaaaa
aaaabaaaaacadaaaaa
aaaaeaafgaaaaaaaaa
aacaacaaaaaaaaaaaa
aaahaaacaaaiaaadaa
aaaaaaaaaaaaaaaaaa
aaaaajfaaaaaaaaaaa
aaaacaaaeaaaaaaaaa
aaaaaaaaaaaaaaaaaa
aaaaaaaaaaaaaaaaaa
aaaaaaaaaaaaaaaaaa
"}
